%%%%%%%%%%%%%%%%%%%%%%
%.%%........%.%......%
%....%%%%%% %.%%%%%%.%
%%%%%%.....P..%......%
%....%.%%%%%%.%%.%%%%%
%.%%%%.%.........%...%
%........%%%.%%%...%.%
%%%%%%%%%%....%%%%%%.%
%..........%%........%
%%%%%%%%%%%%%%%%%%%%%%