%%%%%%%%%%%%%%%%%%%%%%
% %%    .   % % .    %
%    %%%%%% % %%%%%% %
%%%%%%     P  %      %
%    % %%%%%% %% %%%%%
% %%%% %     .   %   %
%  .     %%% %%%   % %
%%%%%%%%%%    %%%%%% %
%.     .   %%    .   %
%%%%%%%%%%%%%%%%%%%%%%